-- -- -- -- -- -- -- -- -- TR TR -- -- -- -- -- -- -- -- --
-- RB -- -- -- -- -- -- -- TR TR -- -- -- -- -- -- -- BB --
-- -- -- -- -- -- -- -- -- TR TR -- -- -- -- -- -- -- -- --
-- -- -- -- -- -- -- -- -- TR TR -- -- -- -- -- -- -- -- --
-- -- -- -- -- -- -- -- -- TR TR -- -- -- -- -- -- -- -- --
-- -- -- -- -- -- -- -- -- TR TR -- -- -- -- -- -- -- -- --
-- -- -- -- -- -- -- -- -- TR TR -- -- -- -- -- -- -- -- --
-- -- -- -- -- -- -- -- -- TR TR -- -- -- -- -- -- -- -- --
-- -- -- -- -- -- -- -- -- TR TR -- -- -- -- -- -- -- -- --
QU QU QU QU -- -- -- -- -- TR TR -- -- -- -- -- QU QU QU QU
QU QU QU QU -- -- -- -- -- TR TR -- -- -- -- -- QU QU QU QU
-- -- -- -- -- -- -- -- -- TR TR -- -- -- -- -- -- -- -- --
-- -- -- -- -- -- -- -- -- TR TR -- -- -- -- -- -- -- -- --
-- -- -- -- -- -- -- -- -- TR TR -- -- -- -- -- -- -- -- --
-- -- -- -- -- -- -- -- -- TR TR -- -- -- -- -- -- -- -- --
-- -- -- -- -- -- -- -- -- TR TR -- -- -- -- -- -- -- -- --
-- -- -- -- -- -- -- -- -- TR TR -- -- -- -- -- -- -- -- --
-- -- -- -- -- -- -- -- -- TR TR -- -- -- -- -- -- -- -- --
-- RB -- -- -- -- -- -- -- TR TR -- -- -- -- -- -- -- BB --
-- -- -- -- -- -- -- -- -- TR TR -- -- -- -- -- -- -- -- --